1111111111111
10010C00C0001
1P00011111001
1C001100E0001
1111111111111